==Metadata==
=Size=
nlines=31
ncol=61
=Types=
G=1
green
W=1000
gray
==Graph==
WWWWWWWWWWWWWWWWWWWWWWWWWWWWWWWWWWWWWWWWWWWWWWWWWWWWWWWWWWWWW
WGGGGGGGWGGGGGGGGGGGWGGGGGGGGGGGGGGGWGGGGGGGGGGGGGGGGGGGGGGGW
WGWWWWGWWWWWWWWWWGWWWGWWWWWWWWWWWGWWWWWWWGWWWWWWWWWWWWWWWWWGW
WGWGGGGGGGGGGGGGGGGGGGGGGGGGGGGGGGGGGGGGGGGGGGGGGGGGGGGGGGWGW
WGWGWWWWWWWWWWWWWWWWWWWWWWWWWWWWWWWWWWWWWWWWWWWWWWWWWWWWWGWGW
WGWGWGGGGGGGGGGGGGGGGGGGGGGGGGGGGGGGGGGGGGGGGGGGGGGGGGGGWGWGW
WGWGWGWWWWWWWWWWWWWWWWWWWWWWWGWWWWWWWWWWWWWWWWWWWWWWWWWGWGWGW
WGWGWGGGGGGGGGGGGGGGGGGGGGGGWGWGGGGGGGGGGGGGGGGGGGGGGGWGWGWGW
WGWGWWWWWWWWWWWWWWWWWWWWWGWWWGWGWWWWWWWWWWWWWWWWWWWWWGWGWGWGW
WGWGGGGGGGGGGGGGGGGGGGGGWGGGGGGGGGGGGGGGGGGGGGGGGGGGWGWGWGWGW
WGWWWWWWWWWWWWWWWWWWWWGWWWWWWWWWWWWWWWWWWWWWWWWWWWWGWGWGWGWGW
WGGGGGGGGGGGGGGGGGGGGGGGGGGGGGGGGGGGGGGGGGGGGGGGGGWGWGWGWGWGW
WWWWWWWWWWWWWWWWWWWWWWWWWWWWWWWWWWWWWWWWWWWWWWWWWGWGWGWGWGWGW
WGGGGGGGGGGGGGGGGGGGGGGGGGGGGGGGGGGGGGGGGGGGGGGGWGWGWGWGWGWGW
WGWWWWWWWWWWWWWWWWWWWWWWWWWWWWWWWWWWWWWWWWWWWWWGWGWGWGWGWGWGW
WGWGGGGGGGGGGGGGGGGGGGGGGGGGGGGGGGGGGGGGGGGGGGWGWGWGWGWGWGWGW
WGWGWWWWWWWWWWWWWWWWWWWWWWWWWWWWWWWWWWWWWWWWWGWGWGWGWGWGWGWGW
WGWGWGGGGGGGGGGGGGGGGGGGGGGGGGGGGGGGGGGGGGGGWGWGWGWGWGWGWGWGW
WGWGWGWWWWWWWWWWWWWWWWWWWWWWWWWWWWWWWWWWWWWGWGWGWGWGWGWGWGWGW
WGWGWGWGGGGGGGGGGGGGGGGGGGGGGGGGGGGGGGGGGGWGWGWGWGWGWGWGWGWGW
WGWGWGWGWWWWWWWWWWWWWWWWWWWWWWWWWWWWWWWWWGWGWGWGWGWGWGWGWGWGW
WGWGWGWGWGGGGGGGGGGGGGGGGGGGGGGGGGGGGGGGGWGWGWGWGWGWGWGWGWGWW
WGWGWGWGWGWWWWWWWWWWWWWWWWWWWWWWWWWWWWWWGWGWGWGWGWGWGWGWGWGWW
WGWGWGWGWGWGGGGGGGGGGGGGGGGGGGGGGGGGGGGGWGWGWGWGWGWGWGWGWGWGW
WGWGWGWGWGWGWWWWWWWWWWWWWWWWWWWWWWWWWWGWGWGWGWGWGWGWGWGWGWGWW
WGWGWGWGWGWGWGGGGGGGGGGGGGGGGGGGGGGGGGWGWGWGWGWGWGWGWGWGWGWGW
WGWGWGWGWGWGWWWWWWWWWWWWWWWWWWWWWWWWWGWGWGWGWGWGWGWGWGWGWGWGW
WGWGWGWGWGWGGGGGGGGGGGGGGGGGGGGGGGGGWGWGWGWGWGWGWGWGWGWGWGWGW
WGWGWGWGWGWWWWWWWWWWWWWWWWWWWWWWWWWGWGWGWGWGWGWGWGWGWGWGWGWGW
WGGGWGWGWGGGGGGGGGGGGGGGGGGGGGGGGGGGGGWGWGWGWGWGWGWGWGWGWGWGW
WWWWWWWWWWWWWWWWWWWWWWWWWWWWWWWWWWWWWWWWWWWWWWWWWWWWWWWWWWWGW
==Path==
Start=1,1
Finish=29,59